㐂 : 匕
㐆 : ノ 勹 ヨ
㐬 : 亠 厶 川
㐮 : 一 ｜ ノ 二 亠 ハ 衣
㑨 : 一 ノ ⺅ 口 大 矢
㑪 : ｜ ノ ⺅ 廾 文 斉
㒒 : 一 ｜ ノ ⺅ 并 木 王 羊 耒
㒵 : ハ 日 白
㒼 : 一 ｜ 入 冂 凵
㓁 : 儿 冖
㓇 : ノ 冫 大
㓛 : 刀 工
㔟 : 丶 力 九 生
㕝 : 十 又 口
㕞 : ｜ 冂 又 尸 巾
㕣 : ハ 口
㕮 : 口 父
㖦 : 一 ｜ 口 日 木 田
㖨 : 口 ヨ 彑 水
㗅 : 十 口 月
㗚 : 口 木 西
㗴 : 口 日 門
㘅 : 亅 二 口 彳 金
㙊 : 土 長
㚑 : 大 ヨ
㚖 : 大 日 白
㚙 : 力 口 大
㛏 : 一 丶 女 水
㝡 : 又 宀 耳
㝢 : ノ 冂 厶 宀 禸 虫
㝫 : 一 夂 宀 ⻖ 生
㝬 : 一 ｜ 二 人 口 大 宀
㝵 : 一 寸 日
㞍 : 丶 九 尸
㟁 : 一 十 厂 山 干
㟢 : 一 亅 口 大 山
㟨 : 山 而
㟴 : 儿 匕 厶 山 田 鬼
㟽 : 二 小 山 示 西
㠀 : 山 灬 鳥
㠯 : 一 ｜ 口
㠶 : ｜ 冂 几 巾
㡀 : ｜ ハ 冂
㡜 : ｜ 丶 二 冂 夕 小 巾 示
㡡 : ｜ 并 冂 厂 口 寸 巾 豆
㣺 : 心
㤗 : 一 二 人 大 心
㤚 : 亅 二 彳 忄
㥯 : 工 ヨ 心 爪
㩮 : 一 ハ 扌 手 臼
㩳 : 又 扌 隹
㫖 : 一 卜 日
㫗 : 子 日
㫪 : 一 ｜ 二 人 大 日
㬎 : 幺 日 灬
㬚 : 亠 厶 攵 日 月
㬜 : 一 厶 土 日 至
㬢 : 一 亅 二 并 戈 手 日 王 羊
㭭 : ノ 刂 口 木
㭷 : 力 木 田
㮇 : ノ 大 心 木
㮈 : 二 大 小 木 示
㮍 : 一 丶 并 冂 刂 木
㮤 : 𠆢 ハ 口 宀 木 穴 谷
㮶 : 一 并 屮 月 木
㯃 : 𠆢 木 水
㯍 : 丶 夕 寸 木 爿
㯰 : 一 ｜ 十 木 目 罒 自
㰏 : 亠 冂 口 木 竹 高
㰦 : 人 勹 厶 土 欠
㳃 : 十 九 氵
㳒 : 厶 大 氵
㴑 : 一 并 屮 广 氵
㴞 : ｜ 氵 日 爪
㵤 : 人 冫 大 氵 羽
㶚 : 十 口 廾 氵 月 西 革
㷀 : 十 火
㷔 : ｜ 日 火 爪
㸅 : 匕 卩 日 火 白 竹
㸿 : 儿 冖 士 牛
㹠 : ノ 乙 凵 犭 屯
㹦 : 刀 口 犭
㹨 : ｜ 犭 日 田
㺃 : 勹 口 犭 ⺾
㺔 : ノ 勹 犭 灬 爪
㽗 : 人 田
㽲 : 一 勹 疒
㽵 : 土 疒
㽷 : 水 疒
㾮 : 日 王 疒 白
㿉 : 一 ｜ ハ 口 疒 目 貝
㿗 : ノ 儿 ハ 木 疒 目 禾 貝 頁
䀹 : 人 大 目
䁘 : 丶 凵 夕 山 目 缶
䂓 : 一 ノ 儿 大 目 矢 見
䄅 : 一 二 人 并 大 小 示
䅈 : 一 ノ 二 人 大 木 禾
䅏 : ノ 尸 木 毛 禾
䅣 : ノ 日 木 王 白 禾
䆴 : 乙 ハ 勹 宀 田 穴 亀
䆿 : ハ 宀 木 爿 目 穴 自
䇦 : 冂 大 竹
䇮 : ノ ⺅ 士 王 竹
䇳 : 二 戈 竹
䈇 : 十 卜 日 竹
䈎 : 一 ｜ 木 世 竹
䉤 : 女 攵 竹 米
䋆 : 一 小 尸 幺 戸 糸
䋖 : ｜ 二 小 幺 ヨ 糸 聿
䋝 : 女 小 ⺌ 幺 糸
䌂 : 一 厶 土 小 尸 幺 糸 至
䌫 : 一 ノ 儿 匚 小 幺 目 糸 臣 見
䍃 : 丶 凵 夕 山 缶
䏮 : 丶 ノ ハ 力 月
䏰 : 丶 刀 心 月
䐈 : 一 ｜ 十 月 目
䐗 : 丶 ノ 土 ⺹ 日 月
䐜 : 一 ｜ ハ 匕 月 目
䐢 : 勹 屮 月
䑓 : 一 ｜ 冖 厶 土 至
䑛 : 一 口 氏 舌
䑶 : 一 ｜ 丶 二 亠 冂 土 月 舟 青
䑺 : 一 ｜ 丶 ノ 冂 舟 虫 風
䒑 : 一 并
䒳 : 乃 ⺾ 木
䒾 : 亠 ⺾ 衣
䓔 : ノ 土 子 ⺾ ⺹
䔈 : ハ 工 ⺾ 目 貝
䔍 : ⺾ 馬
䔥 : ｜ ノ ヨ ⺾ 水 米 隶
䕃 : 𠆢 ⺾ ⻖ 長
䖝 : ノ 虫
䖸 : 亅 戈 手 虫
䗥 : 人 彳 止 虫
䗪 : 一 凵 广 灬 虫
䘏 : ⻏ 皿 血
䙁 : 戈 衤
䙥 : 一 ｜ 𠆢 衤 雨
䚡 : ｜ 勹 心 月 田 角
䚯 : 刂 言
䜌 : 小 幺 糸 言
䝤 : 并 大 小 日 豸
䟽 : 亠 厶 口 川 足
䠖 : 二 人 勹 口 欠 足
䡄 : 几 車
䡎 : 一 尸 戸 車
䢵 : 二 厶 ⻏
䦰 : 乙 勹 田 門 亀
䧧 : 亅 并 ⻖ 戈 手 王 羊
䧺 : 一 ノ 口 隹
䨄 : 一 𠆢 酉 隹
䨩 : ｜ 二 小 日 田 示 雨
䪼 : ｜ ハ 凵 山 目 貝 頁
䬻 : 二 戈 食
䯂 : 木 馬
䯊 : 一 亅 冂 冖 口 月 骨
䯒 : 亅 二 冂 冖 彳 月 骨
䯨 : 亠 冂 口 木 高
䰗 : ｜ 乙 亅 勹 王 田 亀
䰠 : ｜ 儿 匕 厶 日 田 鬼
䳄 : 匕 止 比 灬 鳥
䳑 : 一 ノ 月 灬 鳥
䴇 : 一 ｜ 𠆢 灬 雨 鳥
䵷 : 土 黽
丏 : 一 勹
丩 : ｜
丬 : ｜ 冫
么 : ノ 厶
亻 : ⺅
亼 : 一 𠆢
仈 : ⺅ ハ
仫 : ノ ⺅ 厶
佤 : 一 丶 乙 ⺅
俦 : 一 ノ 二 ⺅ 寸
俱 : 一 ⺅ ハ 目
倂 : 一 ⺅ 十 干
傈 : ⺅ 木 西
傕 : ⺅ 冖 隹
傣 : 一 丶 亅 二 人 ⺅ 冫 大 水
傱 : 人 彳 止
傻 : 丶 ノ ⺅ 儿 囗 夂
僙 : 一 ｜ ⺅ ハ 凵 日 田 黄
僡 : 一 ⺅ 心 虫
僳 : ⺅ 米 西
兠 : ｜ 儿 冫 匕 日 白
关 : 一 二 人 并 大
养 : ｜ ノ ハ 并 王 羊
凃 : 二 𠆢 冫 小 示
凊 : 一 ｜ 二 亠 冂 冫 土 月 青
剝 : 亅 冫 刂 ヨ 彑 水
剬 : 刂 山 而
劄 : 一 𠆢 刂 口 竹
勊 : 儿 力 十 口
勐 : 力 子 皿
勻 : 二 勹
匇 : 勹 夕
匤 : 丶 匚 王
卧 : 匚 卜 臣
卺 : 一 卩 水
卽 : 匕 卩 日 白
叴 : 九 口
吒 : ノ 匕 口
吞 : 一 二 人 口 大
吤 : ｜ ノ 𠆢 口
呕 : 丶 ノ 匚 口
呬 : 儿 口 囗
咊 : ノ 口 木 禾
咠 : 口 耳
哃 : 一 冂 口
哱 : 冖 十 口 子
哳 : 口 扌 斤
啽 : 一 𠆢 口 廾
嗝 : 一 儿 冂 口 鬲
嘇 : 𠆢 厶 口 彡
嘨 : ｜ ノ 口 ヨ 水 米 隶
噇 : 口 立 里
噓 : 一 ｜ 匕 卜 厂 口 虍
噶 : 人 勹 口 ⺾ 日
嚲 : 一 ｜ 亠 十 口 子 日 田
圡 : 丶 土
埗 : ノ 亅 土 小 止
埻 : 亠 口 土 子
墋 : 𠆢 厶 土 彡
增 : 丶 ハ 并 口 土 日
墪 : 亠 口 土 子 攵
壃 : 一 土 田
壠 : 一 乙 土 月 立
壴 : 一 并 十 口 士 豆
复 : 一 ノ 夂 日
夽 : 二 厶 大
姸 : 一 十 女 干
娗 : ノ 士 女 廴 王
媄 : 并 大 女 王 羊
嫰 : 人 勹 口 女 木 欠
寎 : 一 人 冂 宀 爿
寬 : 丶 儿 宀 ⺾ 目 見
尃 : 一 ｜ 丶 十 寸 日
尒 : 𠆢 小
屛 : 一 十 尸 干
屟 : 一 ｜ 尸 木 世
岧 : 刀 口 山
岭 : 一 ｜ 山
峐 : ノ 亠 山 幺 玄
崐 : 匕 山 日 比
崝 : 二 亠 土 山 月 青
崠 : 一 ｜ 山 日 木 田
嵇 : 丶 ノ 尢 山 木 尤 禾
嵓 : 口 山 品
嶗 : 冖 力 山 火
嶤 : 一 儿 土 山
巑 : ノ 儿 ハ 土 山 目 貝
巗 : 厂 口 山 工 攵 耳
巢 : 巛 木 田
幷 : 一 十 干
庹 : 一 凵 尸 广
廙 : ｜ 二 ハ 广 田
廹 : 廴 日 白
廽 : ｜ 囗 廴 罒
开 : 一 ノ 十 干 廾
弞 : 人 勹 弓 欠
徵 : 一 ノ 土 士 山 彳 攵 王
德 : 一 十 彳 心 罒
怢 : ノ 二 人 大 忄
惮 : 十 ⺌ 忄 日 田
愺 : 十 忄 ⺾ 日
懵 : 冖 忄 ⺾ 目 罒
戾 : 一 丶 ノ 大 尸 戸 犬
扡 : ｜ 乙 匕 扌 也
扻 : 人 勹 扌 欠
抅 : 勹 厶 扌
抙 : 扌 手
挲 : ノ 小 氵 手
挻 : ノ 廴 扌 止 疋
捙 : 扌 車
揫 : ノ 手 木 火 禾
揭 : 人 勹 扌 日
揷 : ノ 十 扌 臼
摹 : 大 ⺾ 手 日
攲 : 一 亅 十 又 口 大 支
敄 : マ 攵 矛
斄 : 一 人 厂 攵 木
斵 : ノ 刀 匚 厶 斤 臣
斸 : ｜ 二 勹 尸 斤 罒 虫
旼 : 文 日
昺 : 一 人 冂 日 西
晈 : 亠 日 父
晚 : 一 ｜ ノ 儿 勹 口 日 免
晣 : 扌 斤 日
晥 : 二 儿 宀 日 元
晭 : ｜ 二 冂 口 日
曆 : ノ 厂 日 木 禾
朁 : 日 牙
朒 : 人 冂 月
杍 : 子 木
枒 : 木 牙
柛 : ｜ 日 木 田
柼 : ハ 宀 木 穴
栁 : 卩 夕 木
栐 : 一 木 水
栘 : 夕 木
栾 : ノ 亅 亠 ハ 木
桉 : 女 宀 木
梐 : 匕 土 木 比
梙 : ｜ 口 木
梫 : 冖 又 ヨ 木
梴 : ノ 廴 木 止 疋
棃 : ノ 勹 木 禾
棤 : ｜ 二 日 木
棷 : 又 木 耳
椃 : 儿 匕 卜 厂 木 虍
椇 : 一 ハ 木 目 貝
楆 : 女 木 西
榰 : ノ 匕 土 ⺹ 日 木
槀 : 亠 冂 口 木 高
槏 : 一 ｜ 丶 ノ ヨ 木
槣 : 一 亅 口 大 宀 木
槩 : 木 牙 艮
槪 : 木 牙 艮
槴 : 一 乙 口 尸 已 戸 木 巴
槶 : 一 口 囗 戈 木
樳 : 口 寸 工 ヨ 木
橫 : 一 ｜ ハ 凵 日 木 田
橺 : 日 木 門
檔 : 亠 并 冖 口 ⺌ 木 田
檡 : 一 并 十 土 干 木 罒
櫳 : 乙 日 月 木 立 音
欋 : 木 目 隹
步 : ノ 亅 小 止
歬 : 一 ｜ 丶 冂 止 舟
歷 : ノ 厂 木 止 禾
歺 : 卜 夕
殁 : 几 又 歹 殳
毇 : 几 又 殳 米 臼
毈 : ｜ 丶 几 卩 又 殳
每 : 一 ノ 毋 母
毗 : 匕 比 田
氊 : 一 ノ 乙 二 亠 口 囗 日
沄 : 二 厶 氵
沪 : 一 尸 氵 戸
沭 : 一 ｜ 丶 儿 十 氵
泭 : ⺅ 寸 氵
泻 : 一 冖 勹 氵
洀 : 一 ｜ 丶 冂 氵 舟
洤 : 入 氵 王
洴 : 一 十 干 氵
浘 : 尸 氵 毛
浛 : 一 𠆢 口 氵
浠 : 一 ｜ 丶 ノ 冂 巾 氵
涀 : 儿 氵 目 見
涁 : 彡 氵 木
涉 : ノ 小 氵 止
涊 : ノ 刀 氵 心
涍 : ノ 土 子 氵 ⺹
涫 : ｜ 口 宀 氵
涮 : ｜ 冂 刂 尸 巾 氵
淂 : 一 寸 氵 日
淐 : 氵 日
淚 : 一 丶 大 尸 氵 戸 犬
渗 : 厶 大 彡 氵
渴 : 人 勹 氵 日
湌 : 一 氵 食
溫 : 人 囗 氵 皿
溴 : 丶 大 氵 犬 目 自
滙 : 匚 氵 隹
漐 : 一 丶 并 十 九 土 干 水
漥 : ハ 土 宀 氵 穴
漵 : 亅 二 𠆢 ハ 小 氵 攵
潠 : ｜ 二 ハ 已 氵
澘 : 氵 日 木
澾 : 并 辶 土 氵 王 羊
濉 : 氵 目 隹
瀊 : 一 ｜ 丶 冂 几 又 氵 殳 皿 舟
瀨 : ハ 刀 口 氵 木 目 貝
瀺 : 一 ｜ 儿 勹 匕 口 氵 比 免
灇 : 一 ｜ 并 又 氵 王 羊 耳
灩 : 一 ｜ 并 厶 口 土 山 氵 皿 豆
炟 : 一 日 火
炻 : 口 火 石
烬 : 丶 尸 火
焈 : 一 尸 已 戸 火
焮 : 人 勹 斤 欠 火
煑 : 丶 ノ 土 ⺹ 日 火
煓 : 山 火 而
熖 : 火 爪 臼
熮 : 𠆢 冫 彡 火 羽
爕 : 火 言
牗 : ｜ 二 广 ヨ 月 片 用 聿
犰 : 九 犭
狀 : 丶 大 爿 犬
猳 : ｜ 又 犭
猹 : 一 犭 日 木
玊 : 丶 王
玔 : 川 王
玨 : 王
琓 : 二 儿 宀 王 元
瑓 : 并 口 木 王
璈 : 土 攵 方 王
璗 : 一 丶 ノ 勹 氵 日 王 勿
璥 : 勹 口 ⺾ 攵 王
璺 : 丶 冖 王 臼
瓖 : 一 ｜ 二 亠 口 王 衣
甁 : 一 丶 十 干 瓦
畬 : 亅 二 𠆢 ハ 小 田 示
畲 : 二 𠆢 小 田 示
疌 : 土 ヨ 走
疰 : 亠 土 疒
疷 : 一 氏 疒
痓 : 一 厶 土 疒
痝 : 丶 尢 彡 尤 疒
瘘 : 女 疒 米
瘨 : 一 ｜ ハ 匕 疒 目
皞 : 十 大 日 白
皡 : 二 十 日 白
皯 : 一 十 又 干 皮
皶 : 一 又 木 皮 目
睘 : 一 亠 口 罒 衣
睼 : 日 疋 目
瞤 : 王 目 門
瞩 : ノ 冂 厶 尸 目 禸 虫
砙 : 一 丶 口 瓦 石
砬 : 口 石 立
硏 : 一 十 口 干 石
硑 : 一 并 口 廾 石
磹 : 十 口 日 石 西
磾 : 一 ｜ 十 口 日 田 石
礛 : ノ 二 匚 口 皿 石 臣
礮 : 亠 口 父 石 馬
礰 : ノ 厂 口 木 止 石 禾
秌 : ノ 木 火 禾
种 : ｜ ノ 口 木 禾
窾 : 二 人 ハ 勹 士 宀 小 欠 示 穴
竧 : 立 身
笒 : 一 𠆢 竹
笻 : 卩 工 竹
筹 : 一 ノ 二 寸 竹
筿 : 夂 木 竹
篰 : 口 ⻏ 立 竹
簞 : 一 ｜ 十 口 日 田 竹
籅 : ハ 竹 臼
籗 : 竹 隹 雨
籯 : 一 ノ 乙 亠 ハ 口 亡 月 目 竹 貝
綠 : 小 幺 ヨ 彑 水 糸
緀 : 一 ｜ 十 女 小 幺 ヨ 糸
緖 : 丶 ノ 土 小 幺 ⺹ 日 糸
緣 : 小 幺 ヨ 彑 糸 豕
繵 : 一 亠 口 囗 小 幺 日 糸
耂 : ノ 土 ⺹
聃 : ｜ 二 冂 耳
聻 : 氵 斤 耳 車
肙 : 口 月
肤 : 一 二 人 大 月
胅 : 一 ノ 二 人 大 月
胊 : 勹 口 月
胦 : 冂 大 月
胵 : 一 厶 土 月 至
胻 : 亅 二 彳 月
脍 : 一 二 𠆢 厶 月
脽 : 月 隹
臁 : 一 ｜ ノ ハ 广 ヨ 月
臖 : ハ 冂 月 臼
舄 : 勹 灬 臼
舼 : 一 ｜ 丶 二 ハ 冂 舟
艉 : 一 ｜ 丶 冂 尸 毛 舟
艗 : 一 ｜ 丶 ハ 冂 皿 舟
艹 : ⺾
芓 : 子 ⺾
茌 : ⺅ 士 ⺾
荢 : 亅 二 宀 ⺾
荣 : 冖 ⺾ 木
菡 : 冫 凵 子 ⺾
菥 : ⺾ 斤 木
萗 : 二 宀 小 ⺾ 示
葟 : ⺾ 日 王 白
蒗 : 氵 ⺾ 艮
蓎 : ｜ 口 广 ヨ ⺾
蔛 : ｜ 勹 ⺾ 斗 月 角
蔾 : ノ 勹 ⺾ 木 禾
薰 : 一 ノ 二 并 ⺾ 灬 車
藙 : 亠 并 几 又 ⺾ 殳 立 豕
藡 : 亠 并 冂 十 辶 口 ⺾ 立 滴
蘤 : 勹 ⺾ 日 灬 爪 白
蘹 : 一 ｜ 亠 忄 ⺾ 罒 衣
虛 : 一 ｜ 匕 卜 厂 虍
蚇 : 尸 虫
蚉 : 文 虫
蚝 : 毛 虫
蛦 : 大 弓 虫
蝑 : 月 疋 虫
蝼 : 女 米 虫
蟥 : 一 ｜ ハ 凵 日 田 虫 黄
蟦 : ハ 十 ⺾ 目 虫 貝
蟬 : 一 ｜ 十 口 日 田 虫
蟵 : 并 厂 口 寸 虫 豆
衯 : ハ 刀 衤
袼 : 口 夂 衤
褷 : 彳 止 疋 衤
覀 : 西
訡 : 一 𠆢 言
諐 : ⺅ 口 川 言
謍 : 冖 火 言
譑 : ノ 冂 口 大 言
譩 : 心 日 立 言 音
譿 : 一 ｜ 二 ヨ 心 言
讝 : 厂 口 工 攵 耳 言
賱 : ハ 冖 目 貝 車
賴 : ハ 刀 口 木 目 貝
贎 : ハ 冂 厶 ⺾ 日 田 目 禸 貝
踌 : 一 ノ 二 口 寸 止 足
躘 : 乙 口 日 月 止 立 足 音
躶 : 木 田 身
輫 : 車 非
轊 : ヨ 車 非
辴 : 一 ｜ 亠 十 厂 口 日 田 衣 辰
郞 : ⻏ 艮
郲 : 人 ⻏ 木
鄕 : 幺 ⻏ 艮
酆 : 并 口 山 ⻏ 豆 非
釄 : 儿 广 木 酉 非
鈗 : 儿 厶 金
鉖 : 冫 夂 金
鋷 : 又 耳 金
錄 : ヨ 彑 水 金
鍊 : 并 口 木 金
鍫 : ノ 木 火 禾 金
鏱 : 十 日 立 金
鏵 : 一 ｜ 二 ⺾ 金
閆 : 一 二 門
阴 : ⻖ 月
隽 : 乃 隹
霔 : 亠 土 氵 雨
霶 : 亠 并 冖 氵 方 立 雨
霻 : ｜ 并 口 日 豆 雨
靇 : 乙 日 月 立 雨 音
靍 : 灬 隹 雨 鳥
頄 : ハ 九 目 貝 頁
颼 : ｜ ノ 冂 又 臼 虫 風
飇 : 丶 ノ 冂 大 犬 虫 風
飋 : ノ 冂 心 王 虫 風
飠 : 食
飰 : 一 ｜ 亠 卜 食
飱 : 一 歹 食
馞 : ノ 冖 十 子 日 木 禾 香
馣 : ノ 乙 大 日 木 禾 奄 香
駼 : 亅 二 𠆢 ハ 小 示 馬
騊 : 凵 勹 山 缶 馬
騚 : 一 并 刂 月 馬
騱 : 大 幺 爪 馬
驒 : 一 ｜ 十 口 日 田 馬
驘 : 一 ノ 乙 亠 口 亡 月 馬
骷 : 冂 冖 十 口 月 骨
魲 : 一 尸 戸 灬 田 魚
魶 : 入 冂 灬 田 魚
鯮 : 二 宀 小 灬 田 示 魚
鰝 : 亠 冂 口 灬 田 高 魚
鱥 : 一 ノ 小 戈 止 灬 田 魚
鱭 : 亠 刀 廾 氏 灬 田 魚 齊
鱺 : 一 ｜ 冂 匕 广 比 灬 田 魚 鹿
鵒 : 𠆢 ハ 口 灬 谷 鳥
鵳 : 一 尸 戸 月 灬 鳥
鶙 : ｜ 亠 并 冂 冖 巾 灬 立 鳥
鶽 : 十 灬 隹 鳥
鷀 : 一 并 幺 灬 鳥
鷣 : 十 日 灬 西 鳥
鸍 : 一 ｜ ハ 冂 灬 爻 鳥
麽 : 儿 幺 广 木 麻
黃 : 一 ｜ ハ 凵 日 田 黄
黑 : ｜ 二 并 口 灬 里 黒
欄 : 并 口 木 門
廊 : 广 ⻏ 艮
朗 : 月 艮
虜 : 力 匕 十 卜 厂 口 田 虍
殺 : 丶 ノ 几 又 木 殳
類 : 丶 ハ 大 犬 目 米 貝 頁
隆 : 一 夂 ⻖ 生
﨏 : 𠆢 ハ 口 土 谷
塚 : 丶 冖 土 豕
﨑 : 一 亅 亠 并 口 山 立
﨓 : 人 ⺅ 勹 寸 ⺾ 欠
﨔 : 一 ハ ⺌ 手 木
凞 : 冫 匚 卩 灬 臣
猪 : 丶 ノ 土 犭 ⺹ 日
神 : ｜ 二 小 日 田 示
祥 : 二 并 小 王 示 羊
福 : 一 二 口 小 田 示
﨟 : 人 勹 ⺾ 日 月
蘒 : 丶 ノ 勹 ヨ ⺾ 木 禾 黽
﨡 : 生 虫
諸 : 丶 ノ 土 ⺹ 日 言
﨤 : 又 辶 尸
都 : 丶 ノ 土 ⻏ ⺹ 日
侮 : 一 ノ ⺅ 毋 母
僧 : ｜ ⺅ ハ 并 口 日
免 : 一 ｜ ノ 乙 儿 刀 勹 口 免
勉 : ノ 儿 力 勹 口 免
勤 : 二 力 十 口 廾 革
卑 : ノ 十 日 白
喝 : 人 勹 口 日
嘆 : 十 口 大 廾 革
器 : 丶 口 大 犬
塀 : 一 十 土 尸 干
墨 : 并 口 土 灬 里 黒
層 : ｜ ハ 并 口 尸 日
屮 : ｜ 凵
悔 : 一 ノ 忄 毋 母
慨 : 忄 牙 艮
憎 : ｜ ハ 并 口 忄 日
懲 : 一 ノ 土 山 彳 心 攵 王
敏 : 一 ノ 攵 毋 母
既 : 牙 艮
暑 : 丶 ノ 土 ⺹ 日
梅 : 一 ノ 木 毋 母
海 : 一 ノ 犭 毋 母
渚 : 丶 ノ 土 氵 ⺹ 日
漢 : 十 口 大 廾 氵 革
煮 : 丶 ノ 土 ⺹ 日 灬
爫 : 爪
琢 : 丶 王 豕
碑 : ノ 十 口 日 白 石
社 : 二 土 小 示
祉 : 二 小 止 示
祈 : 二 小 斤 示
祐 : 一 ノ 二 口 小 示
祖 : 一 二 小 目 示
祝 : 二 儿 口 小 示
禍 : 二 冂 口 囗 小 示
禎 : 二 ハ 卜 小 目 示 貝
穀 : 一 ノ 冖 几 又 士 木 殳 禾
突 : 丶 ハ 大 宀 犬 穴
節 : 卩 竹 艮
練 : 并 口 小 幺 木 糸
縉 : ｜ 二 并 小 幺 日 糸
繁 : 一 ノ 小 幺 攵 毋 母 糸
署 : ノ 土 ⺹ 日 罒
者 : 丶 ノ 土 ⺹ 日
臭 : 丶 大 犬 目 自
艹 : ｜ 卜
艹 : 十 ⺾
著 : 丶 ノ 土 ⺾ ⺹ 日
褐 : 人 勹 日 衤
視 : 二 儿 小 目 示 見
謁 : 人 勹 日 言
謹 : 二 十 口 廾 言 革
賓 : 一 ノ ハ 宀 小 目 貝
贈 : ｜ ハ 并 口 日 目 貝
辶 : 辶
逸 : 一 ｜ 丶 儿 勹 辶 口 免
難 : 十 口 大 廾 隹 革
響 : 幺 ⻏ 日 立 艮
頻 : ハ 小 止 目 貝 頁
𠀋 : 一 丶 ノ
𠂉 : 一 ノ
𠂢 : ノ 斤
𠂤 : 口
𠆢 : 𠆢
𠈓 : 一 ｜ ⺅ 冂 凵 山
𠌫 : 一 ｜ ⺅ 田
𠍱 : ⺅ 木 隹
𠎁 : ⺅ 并 灬 里 黒
𠏹 : 丶 ⺅ 囗 王 西
𠑊 : 一 ｜ 二 ⺅ 厂 ⺌ 攵 耳
𠔉 : 丶 ノ 二 ハ
𠗖 : 𠆢 ハ 冫 口 谷
𠘨 : 几
𠝏 : 一 人 𠆢 刀 口
𠠇 : 一 ｜ ノ 刀 刂 厶
𠠺 : 二 儿 力 元
𠢹 : ハ 力 广 田 黄
𠥼 : 十 斗
𠦝 : 十 日
𠫓 : 亠 厶
𠬝 : 卩 又
𠮟 : 匕 口
𠵅 : ⺅ 匕 口 ⺾
𠷡 : 一 𠆢 口 目 自
𠹤 : 口 土 心
𠹭 : 亅 口
𠺕 : ノ 刀 厶 口 田
𠽟 : 口 癶 虫
𡈁 : 囗 日 王 白
𡈽 : 丶 土
𡉕 : 丶 九 土
𡉴 : ノ 土
𡉻 : 十 九 土
𡋗 : 二 𠆢 厶 土
𡋤 : 丶 土 尸
𡋽 : 土 赤
𡌛 : 又 土 田
𡌶 : 一 ｜ 并 土
𡍄 : 十 口 土 尸
𡏄 : 二 土 小 目 示
𡑭 : 一 ｜ 𠆢 并 口 土 日
𡑮 : 一 丶 ノ 二 土 宀
𡗗 : 一 二 人
𡙇 : 一 ノ 日
𡚴 : 女 山
𡜆 : 乙 刀 女 已 巴
𡝂 : 士 女 爿
𡢽 : 女 田 雨
𡧃 : 亅 二 宀
𡱖 : 一 ノ 尸 木
𡴭 : 乙 山
𡵅 : 山 川
𡵢 : 一 ノ 山 攵
𡵸 : 尸 山
𡶒 : ｜ ノ 山 弓
𡶜 : 丶 山 斤
𡶡 : ｜ 二 并 十 山
𡶷 : 夕 山 舛
𡷠 : 几 又 山 扌 殳
𡸳 : 一 ｜ 儿 十 山
𡸴 : 一 人 𠆢 口 山
𡼞 : ノ 土 山 ⻏ ⺹ 日
𡽶 : 山 廾 田 目 自 鼻
𡿺 : 丶 ノ 口 巛
𢅻 : ｜ 冂 又 巾 隹
𢈘 : 一 ｜ 丶 ノ 广
𢌞 : 冂 已 廴
𢎭 : ｜ 冂 巾 弓
𢛳 : 一 十 心 罒
𢡛 : ｜ 二 冂 凵 山 氵 心
𢢫 : 一 二 人 心 日 木
𢦏 : ノ 十 土 弋
𢪸 : 乙 卩 夕 手
𢭆 : ノ 乃 扌 木 禾
𢭏 : 一 ノ 二 寸 扌
𢭐 : 冖 力 ⺌ 扌
𢮦 : 一 人 𠆢 口 扌
𢰝 : ノ 厂 扌 ⺾ 戈
𢰤 : 亅 口 扌 立
𢷡 : 一 人 冂 扌 木
𣆶 : 一 ｜ 儿 勹 口 日 免
𣇃 : ｜ 二 人 并 日
𣇄 : 扌 斤 日
𣇵 : 日 月
𣍲 : 一 二 女 月 五
𣏐 : 夕 木
𣏒 : 丶 九 木
𣏓 : 二 勹 木
𣏕 : 儿 十 木
𣏚 : 木 氏
𣏟 : 儿 十
𣏤 : 木 父
𣑊 : 一 ｜ ノ 土 木
𣑋 : 宀 寸 木
𣑑 : 子 宀 木
𣑥 : 一 ノ 亅 土 ⺹ 木
𣓤 : 一 ｜ 儿 十 木
𣕚 : ノ ⺾ 戈 木
𣖔 : 厂 子 日 木
𣗄 : 亠 川 ⺾ 亡 木
𣘸 : 木 灬 里 黒
𣘹 : ハ 宀 木 田
𣘺 : 一 ｜ ノ 冂 口 木
𣙇 : 土 木 隹
𣜌 : 木 臼 鼠
𣜜 : 冂 厶 ⺾ 日 木 田 禸
𣜿 : 一 ｜ ⺾ 木 世
𣝣 : 寸 木 罒 艮
𣝤 : 辶 山 木 隹
𣟧 : 一 ｜ ハ 辶 口 木 目 貝
𣟿 : 冫 ⺾ 日 木
𣠤 : 一 ノ 儿 大 木 目 矢 見 隹
𣠽 : 一 冂 凵 十 口 廾 月 木 西 革
𣪘 : 几 匕 又 日 殳 白
𣱿 : 入 氵
𣳾 : 亅 二 人 并 冫
𣴀 : 刀 氵
𣴎 : 并 水 王 羊
𣵀 : 工 氵 日
𣷓 : ノ 口 氵 木 禾
𣷹 : ノ 大 氵 水
𣷺 : 冫 又 氵 羽
𣽾 : 儿 氵 目 立 見
𤂖 : 亠 口 小 彡 氵 日
𤄃 : 口 氵 舌 門
𤇆 : 囗 火
𤇾 : 冖 火
𤎼 : 丶 亠 口 小 尢 火 尤
𤘩 : 又 牛
𤚥 : 一 𠆢 厶 口 牛
𤟱 : 一 ノ 夂 犭 日
𤢖 : 口 犭 木
𤩍 : 一 二 人 𠆢 大 王
𤭖 : 一 丶 乙 厶 長
𤭯 : 一 丶 乙 日 水 白
𤰖 : 又 田
𤴔 : 止 疋
𤸎 : ノ 亅 人 日 疒
𤸷 : ｜ ノ 冂 口 巾 ヨ 疒
𤹪 : 匚 口 疒 品
𤺋 : 𠆢 彡 疒 車
𥁊 : 一 夂 皿
𥁕 : 人 囗 皿
𥄢 : 木 目
𥆩 : ｜ 儿 日 目
𥇍 : 十 卜 日 目
𥇥 : 一 人 𠆢 口 目
𥈞 : ｜ 二 冂 凵 山 目
𥉌 : 一 𠆢 口 ⺾ 目
𥐮 : 口 尸 石
𥒎 : 二 口 戈 石
𥓙 : 口 木 石
𥔎 : 一 亅 口 石 立
𥖧 : 匕 口 灬 石 鳥
𥝱 : ノ 亅 マ 木 禾
𥞩 : 一 ノ 并 廾 木 禾
𥞴 : ノ 口 土 木 禾
𥧄 : 乙 ハ 勹 宀 田 穴 亀
𥧔 : ハ 宀 气 穴 米
𥫣 : 一 勹 竹
𥫤 : 弓 竹
𥫱 : ノ 乙 凵 屯 竹
𥮲 : 竹 長
𥱋 : 丶 刀 氵 木 竹
𥱤 : ｜ ⺅ 彡 攵 竹
𥶡 : 一 ｜ 亅 𠆢 冂 廾 冊 竹 車
𥸮 : 土 米
𥹖 : 又 皮 米
𥹢 : 米 耳
𥹥 : ⺌ ヨ 米
𥻂 : 并 口 木 米
𥻘 : 夕 巛 米 舛
𥻨 : 一 冖 十 宀 小 幺 米 糸
𥼣 : 一 ｜ ノ 灬 米 無
𥽜 : 匕 卜 厂 心 田 米 虍
𥿔 : ノ 土 小 幺 糸
𥿠 : 一 ｜ ノ 冂 小 巾 幺 糸
𥿻 : 匕 小 幺 日 糸
𦀌 : 口 女 小 幺 糸
𦀗 : 土 小 幺 糸 赤
𦁠 : 小 幺 日 月 糸
𦃭 : 小 山 幺 糸 鳥
𦉰 : 一 并 冂
𦊆 : 止 罒
𦍌 : 并 王
𦐂 : 冫 戈 羽
𦙾 : 又 土 月
𦚰 : 刀 月
𦜝 : ｜ ノ 廾 文 月 斉
𦣝 : ｜ 匚 臣
𦣪 : 一 ノ 匚 口 皿 臣
𦥑 : 臼
𦥯 : 冖 爻 臼
𦧝 : 一 口 廴 止 疋 舌
𦨞 : 一 ｜ 丶 二 儿 冂 元 舟
𦩘 : 一 ｜ 丶 冂 宀 疋 舟
𦪌 : 一 ｜ 丶 亅 冂 口 大 宀 舟
𦪷 : 一 ｜ 丶 并 冂 土 灬 舟 里 黒
𦫿 : 又 ⺾
𦰩 : 二 人 口 ⺾
𦱳 : 一 并 凵 幺
𦳝 : 一 ノ 勹 ⺾ 曰 勿
𦹀 : 小 幺 ⺾ 田 糸
𦹥 : ⺾ ⻖ 長
𦾔 : ｜ ⺾ 日 隹
𦿶 : 一 并 刀 刂 弓 ⺾ 月
𦿷 : 乙 勹 犭 ⺾ 田 亀
𦿸 : 一 廴 ⺾ 止 疋 虫
𧃴 : 一 ⺅ 宀 小 幺 ⺾ 日 白 糸
𧄍 : 一 儿 冫 土 ⺾ 羽
𧄹 : ⺾ 戈 日 立 言 音
𧏚 : 一 冖 几 又 士 殳 虫
𧏛 : 寸 虫 言
𧏾 : 一 ノ 匚 口 ⺾ 虫
𧐐 : 一 ｜ 二 ハ 土 目 虫 貝
𧑉 : 目 自 虫
𧘔 : 一 ｜ 卜 衤
𧘕 : 一 卜 衤
𧘱 : 匕 比 衤
𧚄 : 亅 戈 手 衤
𧚓 : ｜ 冂 巾 氏 衤
𧜎 : 一 ハ ⺌ 手 衤
𧜣 : 灬 衤 鳥
𧝒 : ハ 田 衤 黄
𧦅 : 丶 ノ 匚 言
𧪄 : ⺅ 言
𧮳 : 𠆢 ハ 口 甘 谷
𧮾 : 一 二 人 𠆢 ハ 口 大 爪 谷
𧯇 : 乙 𠆢 ハ 口 田 立 谷 竜
𧲸 : 卜 口 豸
𧶠 : 儿 ハ 囗 士 目 貝
𧸐 : 二 ハ 弋 目 貝
𧾷 : 口 止 足
𨂊 : 冂 口 土 止 足
𨂻 : ｜ 口 日 止 爪 足
𨉷 : 𠆢 ハ 口 宀 谷 身
𨊂 : 并 灬 身 里 黒
𨋳 : 囗 大 車
𨏍 : 冖 木 火 車
𨐌 : 一 二 并 十 王 立 羊 辛
𨑕 : 辶 口
𨕫 : ｜ 辶 日 礻
𨗈 : 亠 辶 口 小 日
𨗉 : 儿 辶 宀 豕
𨛗 : 乙 口 已 ⻏ 巴
𨛺 : 一 ｜ 二 ハ ⻏
𨥆 : ノ 入 久 金
𨥉 : 山 金
𨥫 : ノ 卩 金
𨦇 : 一 二 人 并 大 金
𨦈 : ｜ 日 金
𨦺 : 乙 口 已 巴 金
𨦻 : 力 田 金
𨨞 : 斤 父 金
𨨩 : ｜ 口 心 金
𨩃 : 一 二 人 日 金
𨩱 : 亠 并 厂 彡 立 金
𨪙 : ｜ 冫 寸 爪 金
𨫍 : 一 ｜ 十 心 日 金
𨫝 : 一 ノ 大 矢 金 隹
𨫤 : マ 辶 用 金
𨯁 : マ 辶 木 用 金
𨯯 : 一 ｜ ハ 辶 口 目 貝 金
𨴐 : ノ 儿 土 門
𨵱 : 一 厶 土 尸 至 門
𨷻 : 小 幺 糸 言 門
𨸟 : 丶 ノ 匚 ⻖
𨸶 : 一 ｜ 二 ハ 十 干 ⻖
𨺉 : ⻖ 木 爪
𨻫 : 乙 ⻖ 田 立 竜
𨼲 : 𠆢 厶 ⺾ ⻖ 長
𨿸 : 一 二 人 大 爪 隹
𩊠 : 一 儿 十 口 ⺌ 廾 革
𩊱 : 一 ノ 十 口 廾 毋 母 革
𩒐 : 一 ハ 厶 土 目 貝 頁
𩗏 : ノ 冂 虫 西 風
𩙿 : 一 ｜ 𠆢 食
𩛰 : 一 丶 亅 冫 食
𩜙 : 一 ｜ 儿 十 食
𩝐 : 一 并 厶 幺 食
𩣆 : 一 并 十 干 馬
𩩲 : 人 冂 冖 勹 日 月 骨
𩷛 : ｜ 勹 月 灬 田 角 魚
𩸕 : 灬 田 長 魚
𩸽 : ⺅ 匕 ⺾ 灬 田 魚
𩹉 : 灬 田 飛 魚
𩺊 : 亠 川 ⺾ 亡 灬 田 魚
𩻄 : 灬 田 罒 豕 魚
𩻛 : 一 ノ 乙 日 灬 田 魚
𩻩 : 止 灬 田 魚
𩿎 : 亅 マ 灬 鳥
𪀚 : ノ 戈 灬 鳥
𪀯 : 一 ノ ⺌ 灬 鳥
𪂂 : 十 日 灬 鳥
𪃹 : 卩 灬 艮 鳥
𪆐 : 木 灬 隹 鳥
𪎌 : 一 并 夂 木 米 麦
𪐷 : ｜ 二 亠 并 口 幺 灬 玄 里 黒
𪗱 : 一 凵 止 目 米 歯
𪘂 : 一 凵 刀 土 止 米 歯
𪘚 : 一 二 凵 口 止 五 米 歯
𪚲 : 乙 勹 月 田 亀
